11111111111111111111
1s                11
1  11111111111111 11
1      111  11111 11
1  11    1     11 11
111111  1111   11 11
1         1   111 11
1 111111111111111 11
1 111             11
1 111 1111111  11111
1     1111111      1
1111111111111  1 111
1              1 111
11 1111111111111 111
11 11111     1   111
11 11111 1 111 11111
11       1     11111
1111111111  11111111
1111111111        e1
11111111111111111111